20#14#
280*B"TileA5.png"I16P0L0
109*B""I0P0L1,
1*B"TileB.png"I97P0L1,
1*B""I0P0L1,
1*B"TileB.png"I98P0L1,
19*B""I0P0L1,
1*B"TileB.png"I114P0L1,
148*B""I0P0L1
280*B""I0P0L2
#
#note